111111111111111111111111
101000100010010001000111
100000000000000000000111
101000010000000000000101
101000010011010000000001
100000000000000000000101
100000000010000000000111
100110000010000000000100
1000000P0000000000000111
110000000000000000000001
111110000000000000000001
100000000000000000000001
100000000000000000000001
100000000000000000000001
111111111111111111111111
