111111111111111111111111111111111111111
100000100000001111111111111111111111111
100001111111111111111111111111111111111
100000110000000000000100011111111111111
100000110000000000000100011111111111111
100000100000000000000000011111111111111
111011111110111111111100011111111111111
110000110000001000000100011111111111111
100000010000001000000100011111111111111
100000010000001000000100011111111111111
100000000000001111111110111111111111111
100000010000001000000000000000000011111
100000010000001000000000000000000011111
110000110000001001100000000000110010001
111111111111111001000000000000010010001
100000000000000000001000111111111111111
100000000000000000001000111111111111111
100000000000000000000000111111111111111
10000000000P000000001000111111111111111
100000000000000000001000111111111111111
100100000000000001001000111111111111111
100110000000000011001000111111111111111
100000000000000000001000111111111111111
100000000000000000001000111111111111111
111111111111111111111000111111111111111
100011111111111111111111111111111111111
111100011111111111111111111111111111111
100000000011111111111111111111111111111
111111111111111111111111111110000000001
100000000000111111111111111110000000001
100000000000111111111111111110000000001
100000000000111111111111111110000000001
100000000000111111111111111110100000101
100000000000111111111111111110000000001
111111111111111111111111111111111111111