
EA ./textures/test.png
WE ./textures/test.png
NO ./textures/test.png
SO ./textures/test.png

F      20,20,0




C     200,200,200




111111
101101
 1 1S1
101001 
 1 111