NO ./textures/bochi5.png
SO ./textures/bochi2.png
WE ./textures/zelij3.png
EA ./textures/osaka2.png

F 220,10,0
C 225,30,0

11111111111
100000000001
10000N000001
111D1111111
1          1
111111111111