NO ./textures/bochi5.png
SO ./textures/bochi2.png
WE ./textures/zelij3.png
EA ./textures/osaka2.png

F 220,10,0
C 225,30,0

        1111111111111111111111111
        1000000000110000000000001
        10110000011100S0000000001
        1001000000000000000000001
1111111110110000011100I0000000001
1000000000110000011101D1111111111
1111011111111101110000I010001
11110111111111011101010010001
11000000110101011100000010001
10000000000000001100000010001
10000000000000001101010010001
1100000111010101111101111000111
10000000000000000000000000001
11111111111111111111111111111
