NO ./textures/bochi5.png
SO ./textures/bochi2.png
WE ./textures/zelij3.png
EA ./textures/osaka2.png

F 220,10,0
C 225,30,0

        1111111111111111111111111
        1000000000110000000000001
        101100000111000S000000001
        100100000000000I000000001
11111111101100000111000I000000001
10000000001100000111011D111111111
11110111111111011100000010001
11110111111111011101010I10001
11000000110101011100000010001
10000000000000001100000010001
10000000000000001101010010001
110000011101010111110111100111
11110111 1110101 101111010001
11111111 1111111 111111111111