NO ./textures/bochi5.png
SO ./textures/bochi2.png
WE ./textures/zelij3.png
EA ./textures/osaka2.png

F 220,100,0
C 225,30,0

1111111
1N011101
11111111