NO ./textures/bochi.png
SO ./textures/bochi2.png
WE ./textures/osaka.png
EA ./textures/osaka2.png

F 220,100,0
C 225,30,0

1111111111111111111111111
1000000000110000000000001
1011000001110000000000001
100100000000000000P000001
1111111110110000000000001
1000000000111111110111111
1111011000000000010010001
1100000011010101110000001
1000000000000000110000001
1000000000000000110100001
1100000111010101111000111
1111011111101011011010001
1111111111111111111111111