NO ./textures/bochi2.xpm42
SO ./textures/bochi2.xpm42
WE ./textures/osaka.png
EA ./textures/osaka2.png

F 12,196,215
C 128,128,128

        1111111111111111111111111
        1000000000110000000000001
        1011000001110000000000001
        10010000000000000E00000011111
1111111110110000011100000000000000011
1000000000110000011101111111000011111
111101111111110111000000100000001
111101111111110111010100100000001
110000001101010111000000000100001
100000000000000011000000100000001
100000000000000011010100100000001
11000001110101011111011110000000111
11110111 1110101 1011110100000001
11111111 1111111 1111111111111111
