NO ./textures/bochi.png
SO ./textures/bochi2.png
WE ./textures/osaka.png
EA ./textures/osaka2.png 

F 12,196,215
C 128,128,128

        1111111111111111111111111
        1000000000110000000100001
        1011000001110000001010001
        1001000000000000W00100001
111111111011000001110000000001111
100000000011000001110111111111 11
11110111111111011100000010001
11110111111111011101010010001
11000000110101011100000100011
10000000000000001100000010001
10000000000000001101010010001
1100000111010101111101111000111
11110111 1110101 101111010001
11111111 1111111 111111111111