NO ./textures/test.png
SO ./textures/zelij_2.png
WE ./textures/osaka.png
EA ./textures/osaka2.png

F 220,100,0
C 225,250,250

111111111111111111111111
101000100010010001000111
100000000010000000000111
101000010000000000000101
101000010011010000000001
100000000000000000000101
100000000010000000000111
100110000010000000000101
100000000000000000000111
110000000000000000000001
111110000000000000000001
100000000000000000000001
1000000000000P0000000001
100000000000010000000001
100000000000010000000001
100000000000010000000001
100000000000010000000001
100000000000010000000001
100000000000010000000001
100000000000010000000001
100000000000010000000001
100000000000010000000001
100000000000010000000001
111111111111111111111111