NO textures/simonkraft/wet_sponge.png
SO textures/simonkraft/wet_sponge.png
WE textures/simonkraft/wet_sponge.png
EA textures/simonkraft/wet_sponge.png

F 164,169,20
C 153,204,255

111111111111111111111
101000001000000000001
101010101011111110001
1000101N00100I0010001
111110101111101011101
100000101000101000001
101111101011101111111
101000001010100000101
101011111010111110101
101010001010100010101
101110101010101010101
100000101010001010001
111111101011111011101
1I0000101000100010001
101110101110101110111
101I00100000100010101
101011111111111010101
1I0010000000I000D0001
101010111011111111101
101000001000000000001
111111111111111111111