NO ./textures/Wolf3D/WALL32.png
SO ./textures/Wolf3D/WALL46.png
WE ./textures/Wolf3D/WALL74.png
EA ./textures/Wolf3D/WALL38.png

F 12,10,0
C 225,30,0

        1111111111111111111111111
        1000000000110000000000001
        1011000001110000000000001
        1001000000000111111000001
        11111111111111111111111111111111
111111111011000001110000000000001
100000000011000001110111111111111
11110111111111011100000010001
11110111111111011101010010001
11000000110101011100000010001
10000000000000001100000010001
10000000000000001101010010001
11000001110101011111011110S0111
1100000000000000000000000001
11111111111111111111111111111