
WE ./textures/test.png
SO ./textures/zelij_2.png
NO ./textures/osaka.png
EA ./textures/osaka2.png

F 255,128,0
C 225,250,250

 11111111111111111
1000000000000000001
1010000010000010001
1000000000000000001
1000100010001000001
1000000000000000001
10101010N0101010001
1000000000000000001
1000100010010000001
1000000000000000001
1010000010000100101 
1000000000000000001
 11111111111111111