

NO ./textures/test.png
SO ./textures/zelij_2.png
WE ./textures/osaka.png
EA ./textures/osaka2.png

F 255,128,0
C 225,250,250

111111111111111111111111111111111111111
100000100000001111111111111111111111111
100001111111111111111111111111111111111
100000110000000000000100011111111111111
100000110000000000000100011111111111111
100000100000000000000000011111111111111
111011111110111111111100011111111111111
110000110000001000000100011111111111111
100000010000001000000100011111111111111
100000010000001000000100011111111111111
100I00000000001111111110111111111111111
100000010000001000000000000000000011111
100000010000001000000000000000000011111
110000110000001001100000000000110010001
111111111111111D01000000000000010010001
100000000000000000001000111111111111111
100000000000000000001000DI1111111111111
1000000I0000000000000000111111111111111
100000000000000000001000111111111111111
1000000I000000000N001000111111111111111
1001000000000I0001001000111111111111111
100110000000000011001000111111111111111
100000000000000000001000111111111111111
100000000000000000001000111111111111111
1111111111111111111111000111111111111111
100011111111111111111111111111111111111
111100011111111111111111111111111111111
1000000000111111111111111111111111111111
1111111111111111111111111111100000000011
1000000000001111111111111111100000000011
100000000000111111111111111110000000001
100000000000111111111111111110000000001
100000000000111111111111111110100000101
100000000000111111111111111110000000001
111111111111111111111111111111111111111