










EA                 ./textures/osaka2.png

    

WE ./textures/test.png



SO ./textures/zelij_2.png

NO ./textures/osaka.png
C               255,128,0

F 110,251,250


                                
11111111111111 1111111   11111111111111111111
1S0000100000001111111111111111111111111
100001111111111111111111111111111111111
10II00110000000000000100011111111111111
10I000110000000000000100011111111111111
10I000100000000000000000011111111111111
11101111111011111111110001111111111111
110000110000001000000100011111111111111
100000010000001000000100011111111111111
100000010000001000000100011111111
100100000000001111111110111111111111111
100000010000001000000000000000000011111
100000010000001000000000000000000011111
110000110000001001100000000000110010001
111111111111111001000000000000010010001
100000000000000000001000111111111111111
100000000000000000001000D11111111111111
100000010000000000000000111111111111111
100000000000000000001000111111111111111
100000010000000000001000111111111111111
100100000000010001001000011111111111111
100110000000000011001000111111111111111
100000000000000100001000111111111111111
100000000000000000001000111111111111111
111111111111111111111100011111111111111
100011111111111111111111111111111111111
111100011111111111111111111111111111111
100000000011111111111111111111111111111
111111111111111111111111111110000000001
100000000000000000000000000000000000001
100000000000111111111111111110000000001
100000000000111111111111111110000000001
100000000000111111111111111110100000101
100000000000111111111111111110000000001
111111111111111111111111111111111111111