
WE ./textures/test.png
SO ./textures/zelij_2.png
NO ./textures/osaka.png
EA ./textures/osaka2.png

F 255,128,0
C 225,250,250

11111111111
100000000001
10000N000001
11111101111
1 1100D1011
111111111111
111111
